1111111111111
10010010001C1
1P0011E100001
1000000000001
1111111111111